{
  "levels": [
    {
      "level_id": "simple_001",
      "grid": [
        "#######",
        "#     #",
        "# @$. #",
        "#     #",
        "#     #",
        "#     #",
        "#######"
      ]
    },
    {
      "level_id": "corner_trap_001",
      "grid": [
        "#######",
        "#     #",
        "# @   #",
        "# $   #",
        "#    .#",
        "#     #",
        "#######"
      ]
    }
  ]
}

